1111111111
1000EE0C01
10P0000001
1111001111
10C0000C01
1111C01111
10MC0M0001
11110C1111
1111111111

